=######===
##  X ####
#        #
#  XCO   #
#        #
#    P   #
#s p B T #
#        #
# TC    E#
##########
