==========
=#########
=#XX X   #
=#    B  #
=#C  #####
=#  C    #
=# C     #
=#  E    #
=#########
==========

