==========
=#####====
## E ####=
#    CX ##
#        #
#    CX  #
##    ####
=##   #===
==#####===
==========