#######===
#     ####
#XCO PP  #
#%###O##O#
#   S  # #  
#B     #s#
#    #   #
#   #    # 
#E M#  p #
##########