##########
#E   B   #
# C# C X #
#  # TP  #
# X## C C#
#  P# T# #
#   C#   #
#   O#   #
#   C# M #
##########
